...............
....*******....
...**.....*....
...*......*....
...*...****....
...*...*.......
.***...*.......
S*.....*******E
...............